00000000000000000000000000000000000000000000000000000000000000000000000000000000000000000000000000000000000000000000000000000000000000000000000000000000000000000000000000000000000000000000000000000000000000000000
00000000000000000000000000000000000000000000000000000000000000000000000000000000000000000000000000000000000000000000000000000000000000000000000000000000000000000000000000000000000000000000000000000000000000000000
00000000000000000000000000000000000000000000000000000000000000000000000000000000000000000000000000000000000000000000000000000000000000000000000000000000000000000000000000000000000000000000000000000000000000000000
00000000000000000000000000000000000000000000000000000000000000000000000000000000000000000000000000000000000000000000000000000000000000000000000000000000000000000000000000000000000000000000000000000000000000000000
00000000000000000000000000000000000000000000000000000000000000000000000000000000000000000000000000000000000000000000000000000000000000000000000000000000000000000000000000000000000000000000000000000000000000000000
00000000000000000000005000000000000000000000000000000000000000000000000000000000222222220002225000000000000005000000000002220000255200000000000000000000000000000000000000000000000000000000440000000000000000000000
00000000000000000000000000000000000000000000000000000000000000000000000000000000000000000000000000000000000000000000000000000000000000000000000000000000000000000000000000000000000000000004440000000000000000000000
00000000000000000000000000000000000000000000000000000000000000000000000000000000000000000000000000000000000000000000000000000000000000000000000000000000000000000000000000000000000000000044440000000000000000000000
00000000000000000000000000000000000000000000000000000000000000000000000000000000000000000000000000000000000000000000000000000000000000000000000000000000000000000000000000000000000000000444440000000000000000000000
00000000000000005000252520000000000000000000009a0000000009a000000000000000000252000000000000002000002200005005005000002000000000022000000400400000000004400400000000000022520000000000004444440000000000000000000000
000000000000000000000000000000000000009a000000bc000000000bc000000000000000000000000000000000000000000000000000000000000000000000000000004400440000000044400440000000000000000000000000044444440000000000000000000000
00000000000000000000000000009a00000000bc000000bc000000000bc000000000000000000000000000000000000000000000000000000000000000000000000000044400444000000444400444000009a000000000000009a0444444440000000000000000000000
0000000000000000000000000000bc00000000bc000000bc000000000bc00000000000000000000000000000000000000000000000000000000000000000000000000044440044440000444440044440000bc00000000000000bc4444444440000000040000000000000
11111111111111111111111111111111111111111111111111111111111111111111100111111111111111111111111111111111111111111111111111111111111111111111111111111111100111111111111111111111111111111111111111111111111111111111
11111111111111111111111111111111111111111111111111111111111111111111100111111111111111111111111111111111111111111111111111111111111111111111111111111111100111111111111111111111111111111111111111111111111111111111